++++++++++++++++++++++++++++++++++++++++++++++++
+                                              +
+    ++++++     ++++++    +++ +++    +++++++   +
+    +          +    +    + + + +    +         +
+    +          +    +    + + + +    +         +
+    +   ++     ++++++    + + + +    ++++++    +
+    +    +     +    +¡@  +  +  +    +         +
+    +    +     +    +¡@  +     +    +         +
+    ++++++     +    +  ¡@+     +    +++++++   +
+                                              +
+    ++++++     +    +    +++++++    +++++++   +
+    +    +     +    +    +          +     +   +
+    +    +     +    +    +          +++++++   +
+    +    +     +    +    ++++++     ++++      +
+    +    +     ++  ++    +          +  ++     +
+    +    +      ++++     +          +   ++    +
+    ++++++       ++      +++++++    +    ++   +
+                                              +
+                                              +
+    +++ +++ +++ +++ +++                       +
+    +   + + + + + + +    +                    +
+    +++ +   + + +++ +++                       +
+      + + + + + ++  +    +                    +
+    +++ +++ +++ + + +++                       +
+                                              +
++++++++++++++++++++++++++++++++++++++++++++++++

